
нкШ░	нк╣Р	нк▓с	нкОт
нкЗу	нк╗§	нк┌▄	нкрй
нкЙ┘	нкО░	нк╝═	нк▓╝
нки┐	нкхц	нкой	нк▓▀
Мщнк	нк┬ч	▓юнк	нк║Ч
нклщ	нкЛ╠	нкЛ┐	нкЛ└
нкмП	нЭнк	нкр»	нкм┬
нкмь	нкЛе	нкрХ	нкнк
нкЛс	нкЗУ	нкЛЕ	нклл
нк╩Е	нкм░	МЗнк	нкМВ
нкЛ╗	нкЛ█	нкМ▀	нкхi
нкл╦	М╬нк	нкЛХ	нк╩э
нк╚­	нкм║	нкНФ	нкнд
нкр├	нкМэ	нк╚Н	нк┤▓
нк─ы	нко█	нкХ┤	нкзц
нкй╝	нк▓Г	нкьн	нкря
нкы╝	нкЙМ	нк╝Ф	нк┼«
нкйш	нк╗­	нк╠П	нкйо
нкГH	нкзЭ	нк╣П	нкН¤
нки№	нкТЭ	нкНж	нк█о
нкШ▓	нк╝д	нкН╗	нк▒П
нк│▓	нкч]	нк│Ь	нк═┐
нкХЦ	нк─Й	нкИА	нк╗Ц
нк▒╠	нкИЯ	нкхе	нкж╣
нкоК	нк┐e	нк├р	нк═Р
нкћш	нкНз	нкЗI	нкЧ^
нкСЙ	нк║й	нкыН	нкИщ
нкэР	нк╝m	нк▒Ж	нкйО
нкИз	нкэ┘	нк╝»	нк┴о
нк─▀	нкиу	нкО╠	нк╗п
нкИ┘	нк╬н	нк╗ф	нк░Т
нкхы	нкс╦	нк¤├	нк║▓
нк╬х	нк░░	нк═Э	нкощ
нк╣п	нкЯЭ	нкНк	нкЗф
нк¤ж	нкяФ	нк┬к	нкхЬ
нк┬▄	нк└О	нкйФ	нкйГ
нк║╬	нкХ║	нкк╝	нк┴Б
нкХч	нкьс	нк╦┬	нкйг
нк╗Д	нкЧј	нкж§	нкич
нкк▄	нк╗¤	нкы─	нк░▀
нк╗Щ	нк╠В	нкЇг	нк┬и
нк┤Э	нк┤т	нк╩З	нк├┼
нк┬Ц	нк═┼	нкНя	нкэо
нк║Б	нк╬»	нкХл	нк┴Щ
нкО»	нк╠╬	нк╬ь	нк╬ф
нк¤ф	нк═┴	нкЙ█	нк└П
нк╠е	нкхЅ	нк┬ь	нк─«
нк╣╚	нкоы	нк┴║	нкжч
нкХ­	нкТж	нк║У	нПнк
нк═и	нк┬Х	нкТЬ	нк╗б
нк╬У	нк═╝	нк▒ь	нк└ю
нк─И	нк║║	нкћС	нкХС
нк┤М	нкТ­	нк┬─	нк╣К
нк└┤	нк┬м	нкН╬	нк║ш
нк┼к	╩»нк	нк─Е	Н╝нк
нк╝П	нкОГ	нккв	нк╠Х
Отнк	Нзнк	Оцнк	оВнк
аЎнк	Нйнк	Н╬нк	О¤нк
нкЉ§	нквЅ	нкУ┬	нк└╦
нк├╬	¤снк	ЛОнк	¤╦нк
ю{нк	Л¤нк	л■нк	лУнк
мхнк	млнк	нк╚И	нк╚З
нк╔└	нк╩х	нкК­	нк╚ф
М═нк	нкн┬	нк╔╝	нк╩о
нк╦┐	нк╩ж	нкв╗	нкМЖ
нкК╠	нк╦«	нкНг	нкКх
нкЫ░	нкмЖ	нк╔й	нккЭ
нкМ╬	нкне	│»нк	╦инк
╠цнк	╚­нк	▒кнк	эШнк
░Онк	│╦нк	Ў┘нк	│цнк
▓снк	▓╩нк	│┬нк	╠┌нк
╔│нк	╩фнк	═унк	═гнк
¤лнк	╬Онк	═чнк	┤хнк
х┬нк	┤Снк	│■нк	Ќ╝нк
│Ннк	хКнк	ринк	хЙнк
х═нк	хынк	Х¤нк	ХЗнк
Ыснк	ХЛнк	ХЯнк	ХСнк
Узнк	и▒нк	иОнк	иунк
иэнк	Ж║нк	И╔нк	ИУнк
╣│нк	║Щнк	╣╣нк	║хнк
╣жнк	╣§нк	║«нк	╗­нк
║┌нк	║рнк	║Мнк	║Унк
э▀нк	тунк	ШФнк	ЖЕнк
╗кнк	╗§нк	э┘нк	╝фнк
укнк	йшнк	Й▓нк	ЙШнк
└├нк	┴Унк	┴гнк	┴Жнк
┬■нк	Йvнк	├«нк	шТнк
├ннк	┼»нк	─тнк	─Днк
─¤нк	┼┌нк	┼Знк	кгнк
┼чнк	┼╠нк	к▄нк	у▓нк
к­нк	╚унк	Клнк	Кенк
Крнк	╚фнк	╚ннк	╚§нк
нкЖб	нкз┴	нкќь	нк══
нк╦┴	нк╬─	нк┬о	нкћэ
нк╠└	нкзэ	нк­¤	нкПщ
нкЙФ	нк┐▀	нк¤╝	нкэ▀
нки█	нкьФ	нкйЫ	нкХЩ
нк╣╣	нкоЦ	нк┤е	нк│╠
нкВи	нк▓╔	нк▓е	нкиЙ
нк═Ц	нкш¤	нкк№	нк║О
нк╦╔	нкрб	нккг	нк║Щ
нк╣г	нкТш	нкк┴	нк┤░
нк─д	нк╣▄	нкэА	нкиЗ
нкжй	нк║▒	нкр░	нк╝с
нкют	нк╣┌	нкжО	нкйД
нкўP	нк╣█	нк┴в	нк╣ж
нк░ф	нк─я	нкзП	нк═А
нк┤Б	нк─т	нкВИ	нкИУ
нк├В	нк╠┌	нк┴┐	нкСп
нкИК	нк▓Д	нк┼█	нк═ц
нкз┼	нкых	нк║М	нк┼З
нк░в	нкЯ╬	нк╠├	нкїо
нкпе	нк│c	нкХМ	нк┐═
нк═Й	нк╬в	нкЙГ	нкол
нк─Г	нк═Ш	нкХ░	нк╬№
Нннк	У╠нк	о┘нк	нк┼┌
Нэнк	Н╗нк	опнк	Оинк
о▄нк	нк░б	нкП~	нкЗ│
нкх║	нк┬я	нк├у	нктМ
нкх╠	нкЙ░	нкН╩	нкНэ
нк─ц	нк║═	нкП═	нк╬П
нк╬к	нкод	нк¤У	нкПZ
нк┐┬	нкћВ	нкХ╣	нк╣┘
нкХх	нкИ╔	нк╗е	нк░т
нкиФ	нкз№	нк╝╩	нк╝С
